I, Calypso, am the one and only, world-renowned, pop rock star and legendary destroyer of demons, vaporizer of vampires and underminer of the undead. Tales of my gazillions of conquests are told near warm campfires across time and space within all galaxies that ever were and ever will be.

A destroyer of evil by day and a destroyer of evil by night.  Wherever the forces of evil gather, I, Calypso, shall be called to annihilate them with the power of over nine-thousand supernovas. Day in and day out, I, Calypso, risk my life, fighting against the forces of darkness, not for the glory or the sexual gratification it provides me... But in order to protect the innocent from a darkness that would otherwise engulf them.

Tonight is a night like every other night.

There have been reports of the undead rising up in droves in Los Demonios. The name of Valhallery the Malevolent is whispered in dark circles, it is said that she is responsible for the recent risings. I, Calypso, shall defeat the evil necromancerette once and for all. The woman I once called... mother, shall die by my hand tonight.

I, Calypso, have arrived at the cemetery on the outskirts of town where Valhallery is residing. My highly outrageous and, some say, very unlikely story begins like so,

Calypso's Highly Unlikely Descent
An Overly Serious Tale Inspired by a True Story by Bill Tyros
Release 1 / Serial number 130214 / Inform 7 build 6G60 (I6/v6.32 lib 6/12N) SD

Graveyard
A statue of Death himself lies in the middle of the graveyard, menacingly towering over an endless sea of great grey and brown tombstones. Beneath a dark and foreboding sky, a thick fog engulfs everything as far as the eye can see.

A small forest path leads to the east. Towards the west, a large tomb lays at the head of a well-trodden path. To the south, a carefully hidden mausoleum can be seen. An archway with stairs leading down underground seems to call out to you from within the fog.

>open abc
Nothing has been unlocked and opened!

>l
Graveyard
The statue of Death lies in the middle of the Graveyard surrounded by endless rows of tombstones.

To the east, you can barely make out a small grove. To the west, you see what looks to be a small tomb. To the south, you see a large building, probably a mausoleum. You see a small archway over some stairs leading downwards.

You can see Ezmerelda here.

>statu
>STATUE
As you look closer, you notice a small box hidden beneath dense shrubberry next to the statue.

A statue of Death hooded, pointing his massive scythe straight to the ground. Below it, lies an engraved poem.

>take lantern
Taken.
An electric lantern of moderate size. 

The lantern is currently switched off.

>toggle lantern
The lantern can't be switched on, its battery isn't charged.

I've always asked myself, why do the undead always have to gather in cemeteries? It's dark, foggy.... It literally smells like death. I don't understand their way of thinking at all. But, you know, maybe that's because I'm not a corpse, yet.

>charge lantern
The lantern is now charged.

>undo
Graveyard
Previous turn undone.

>charge lantern
The lantern is now charged.

* * *

>undo
Graveyard
Previous turn undone.

>toggle lantern
The lantern can't be switched on, its battery isn't charged.

>LOOK
Graveyard
The statue of Death lies in the middle of the Graveyard surrounded by endless rows of tombstones.

To the east, you can barely make out a small grove. To the west, you see what looks to be a small tomb. To the south, you see a large building, probably a mausoleum. You see a small archway over some stairs leading downwards.

You can see a small box (empty) and Ezmerelda here.

Ok, ok, ok. It's not that bad really. I'll find a way into the crypt, get the job done and leave as soon as possible. God knows, I'm a busy man. I don't have time to deal with every single wannabe necromancer who decides to occupy the local cemetery and wreck havoc like the pre-pubescent teen that he is.

>down
The lantern can't be switched on, its battery isn't charged.

I'm definitely not going in there with this lantern turned off. Now, that would be stupid.

Man. Maybe, I'm just too jaded. I'm done this so many, many, many, many, many, many, times that nothing surprises me anymore. I've spent every single day of my life fighting the undead across the world and, I don't know, I feel as if something is missing. Maybe after I cut this losermancer's head off, who probably can't even summon a golem yet, I'll book an appointment with a psychologist.

>toggle lantern
The lantern can't be switched on, its battery isn't charged.

Lilith... God, I loved you Lilith. Why did she have to leave me? I was really happy with her, you know? Granted, I didn't really spend that much time with her... I can't believe she thinks that I'd rather spend my time killing ghouls, solving devious puzzles and burying the dead undead than spend time with her. God... She was an angel, literally and figuratively. Well, I guess if she was a literal angel then she would be a figurative angel by default, right? Anyway, the point is that if you've never been with a girl with wings you're missing out.

>charge lantern
The lantern is now charged.

>toggle lantern
You switch the lantern on.

>i
You are carrying:
  a lantern (providing light)
  a top hat (being worn)
  a gothic trenchcoat (being worn)
  a pair of tight jeans (being worn)
  a pair of knee high boots (being worn)
  a long tube (being worn and open)
    a dull katana
  a messenger bag (being worn and open)
    a Monster Manual

We had so many good memories. A while back, an archdemon was about to suck her into Hell, but I got there just in time and saved her from a life of eternal torment. At the time, she was going out with this angelic douchebag named Metatron. He was gone really fast, after Lilith and I partook in one or two Transformers movie marathons.

>down
The lantern is all ready on.

Good, this lantern should give off enough light to let me enter the crypt.

Entrance
TODO:.

You enter the dark crypt guided by the lantern in your hands. "Finally, my God let's get this over with before I die of boredom."

* * *

>open abc
Nothing has been unlocked and opened!

>statue
As you look closer, you notice a small box hidden beneath dense shrubberry next to the statue.

A statue of Death hooded, pointing his massive scythe straight to the ground. Below it, lies an engraved poem.

>take lantern
An electric lantern of moderate size. A lever is attached beneath the lantern's base. 

The lantern is currently switched off.

Taken.

I've always asked myself, why do the undead always have to gather in cemeteries? It's dark, foggy.... It literally smells like death. I don't understand their way of thinking at all. But, you know, maybe that's because I'm not a corpse, yet.

>toggle lantern
You switch the lantern on.

>LOOK
Graveyard
The statue of Death lies in the middle of the Graveyard surrounded by endless rows of tombstones.

To the east, you can barely make out a small grove. To the west, you see what looks to be a small tomb. To the south, you see a large building, probably a mausoleum. You see a small archway over some stairs leading downwards.

You can see a small box (empty) and Ezmerelda here.

>LOOK
Graveyard
The statue of Death lies in the middle of the Graveyard surrounded by endless rows of tombstones.

To the east, you can barely make out a small grove. To the west, you see what looks to be a small tomb. To the south, you see a large building, probably a mausoleum. You see a small archway over some stairs leading downwards.

You can see a small box (empty) and Ezmerelda here.

The lantern's light begins to go out in short flashes.

>LOOK
Graveyard
The statue of Death lies in the middle of the Graveyard surrounded by endless rows of tombstones.

To the east, you can barely make out a small grove. To the west, you see what looks to be a small tomb. To the south, you see a large building, probably a mausoleum. You see a small archway over some stairs leading downwards.

You can see a small box (empty) and Ezmerelda here.

>LOOK
Graveyard
The statue of Death lies in the middle of the Graveyard surrounded by endless rows of tombstones.

To the east, you can barely make out a small grove. To the west, you see what looks to be a small tomb. To the south, you see a large building, probably a mausoleum. You see a small archway over some stairs leading downwards.

You can see a small box (empty) and Ezmerelda here.

The lantern loses power and switches off!

>charge lantern
You turn the lever beneath the lantern clockwise about forty-six times.
The lantern is now charged.

>lantern
An electric lantern of moderate size. A lever is attached beneath the lantern's base. 

The lantern is currently switched off.

>lever
A small lever meant to be twisted clockwise, probably used for charging the lantern.

>charge lantern
The lantern is allready charged.

>charge lever
(first taking the lever)
That seems to be a part of the lantern.

Ok, ok, ok. It's not that bad really. I'll find a way into the crypt, get the job done and leave as soon as possible. God knows, I'm a busy man. I don't have time to deal with every single wannabe necromancer who decides to occupy the local cemetery and wreck havoc like the pre-pubescent teen that he is.

>turn lever
The lantern is allready charged.

>push lever
The lantern is allready charged.

Man. Maybe, I'm just too jaded. I'm done this so many, many, many, many, many, many, times that nothing surprises me anymore. I've spent every single day of my life fighting the undead across the world and, I don't know, I feel as if something is missing. Maybe after I cut this losermancer's head off, who probably can't even summon a golem yet, I'll book an appointment with a psychologist.

>pull lever
The lantern is allready charged.

Lilith... God, I loved you Lilith. Why did she have to leave me? I was really happy with her, you know? Granted, I didn't really spend that much time with her... I can't believe she thinks that I'd rather spend my time killing ghouls, solving devious puzzles and burying the dead undead than spend time with her. God... She was an angel, literally and figuratively. Well, I guess if she was a literal angel then she would be a figurative angel by default, right? Anyway, the point is that if you've never been with a girl with wings you're missing out.

* * *

>toggle lantern
You switch the lantern on.

>charge lantern
You turn the lever beneath the lantern clockwise about twenty-two times.
The lantern is now charged.

Lilith... God, I loved you Lilith. Why did she have to leave me? I was really happy with her, you know? Granted, I didn't really spend that much time with her... I can't believe she thinks that I'd rather spend my time killing ghouls, solving devious puzzles and burying the dead undead than spend time with her. God... She was an angel, literally and figuratively. Well, I guess if she was a literal angel then she would be a figurative angel by default, right? Anyway, the point is that if you've never been with a girl with wings you're missing out.

>down
The lantern is all ready on.

Good, this lantern should give off enough light to let me enter the crypt.

Entrance
TODO:.

You enter the dark crypt guided by the lantern in your hands. "Finally, my God let's get this over with before I die of boredom."

>drop lantern
Dropped.

>l
Entrance
TODO:.

You can see a lantern (providing light) here.

>n
Darkness
It is pitch dark, and you can't see a thing.

>w
Darkness
It is pitch dark, and you can't see a thing.

>LOOK
Darkness
It is pitch dark, and you can't see a thing.

TODO:It's pretty dark in here. A.

>LOOK
Darkness
It is pitch dark, and you can't see a thing.

TODO:It's pretty dark in here. B.

>e
Darkness
It is pitch dark, and you can't see a thing.

>w
Darkness
It is pitch dark, and you can't see a thing.

TODO:It's pretty dark in here. B.

>s
It is pitch dark, and you can't see a thing.

TODO:It's pretty dark in here. B.

>s
It is pitch dark, and you can't see a thing.

>LOOK
Darkness
It is pitch dark, and you can't see a thing.

>s
It is pitch dark, and you can't see a thing.

>take lantern
The last time you saw the lantern, it was at "the Entrance".

TODO:It's pretty dark in here. B.

>s
It is pitch dark, and you can't see a thing.

>s
It is pitch dark, and you can't see a thing.

>s
It is pitch dark, and you can't see a thing.

TODO:It's pretty dark in here. A.

>e
Darkness
It is pitch dark, and you can't see a thing.

>e
Darkness
It is pitch dark, and you can't see a thing.

TODO:It's pretty dark in here. C.

>w
Darkness
It is pitch dark, and you can't see a thing.

TODO:It's pretty dark in here. C.

>so
Most connecting and comparative words are not necessary.

>so
Most connecting and comparative words are not necessary.

>s
Entrance
TODO:.

You can see a lantern (providing light) here.

>take lantern
Taken.

>n
Corridor
TODO:CORRIDOR

>n
You can't go that way.

From here, you can go to the south, the east and the west.

>w
Storage Room
TODO:STORAGE ROOM

You can see a bucket (empty) here.

>e
Corridor
TODO:CORRIDOR

>e
Prison
TODO:PRISON

You can see an iron gate and a rotten desk (on which are a scribbled note and a puzzle cube (in which is a silver key)) here.

>go gate
(first opening the iron gate)
It seems to be locked.

>smash cube
Taken.
A wooden puzzle cube, just the right size to grasp in the palm of your hand.

Each side of the cube has a single button in the middle with a different dotted code on it, including: an unpressed one-dot button, an unpressed two-dot button, an unpressed three-dot button, an unpressed four-dot button, an unpressed five-dot button and an unpressed six-dot button.

In the puzzle cube is a silver key.

You smash the innocent cube on the floor with a surprising amount of force. After spinning on itself for a while, the cube falls with its unpressed four-dot button facing up. It cracks open wide and a silver key slides out of it and onto the ground.

>take key
Taken.
A slender silver key with a handle shaped in the image of a headless woman's body with large breasts and no pubic hair. Perverted shizzle.

>open gate with key
You unlock the iron gate.

>go gate
(first opening the iron gate)

Cell
TODO:CELL

>gate
That's neither a verb I recognise nor a keyword you can use right now.

>w
You can't go that way.

From here, the only way out is to the outside.

>outside
Prison
TODO:PRISON

You can see a broken puzzle cube (empty), an iron gate and a rotten desk (on which is a scribbled note) here.

>inside
Cell
TODO:CELL

* * *

>take lantern
An electric lantern of moderate size. A lever is attached beneath the lantern's base. 

The lantern is currently switched off.

Taken.

I've always asked myself, why do the undead always have to gather in cemeteries? It's dark, foggy.... It literally smells like death. I don't understand their way of thinking at all. But, you know, maybe that's because I'm not a corpse, yet.

>LOOK
Graveyard
The statue of Death lies in the middle of the Graveyard surrounded by endless rows of tombstones.

To the east, you can barely make out a small grove. To the west, you see what looks to be a small tomb. To the south, you see a large building, probably a mausoleum. You see a small archway over some stairs leading downwards.

You can see a small box (empty) and Ezmerelda here.

>toggle lanter
>TOGGLE LANTERN
You switch the lantern on.

>LOOK
Graveyard
The statue of Death lies in the middle of the Graveyard surrounded by endless rows of tombstones.

To the east, you can barely make out a small grove. To the west, you see what looks to be a small tomb. To the south, you see a large building, probably a mausoleum. You see a small archway over some stairs leading downwards.

You can see a small box (empty) and Ezmerelda here.

* * *

>LOOK
Graveyard
The statue of Death lies in the middle of the Graveyard surrounded by endless rows of tombstones.

To the east, you can barely make out a small grove. To the west, you see what looks to be a small tomb. To the south, you see a large building, probably a mausoleum. You see a small archway over some stairs leading downwards.

You can see a small box (empty) and Ezmerelda here.

The lantern's light begins to go out in short flashes.

>charge lantern
You turn the lever beneath the lantern clockwise about twenty-six times.
The lantern is now charged.

>LOOK
Graveyard
The statue of Death lies in the middle of the Graveyard surrounded by endless rows of tombstones.

To the east, you can barely make out a small grove. To the west, you see what looks to be a small tomb. To the south, you see a large building, probably a mausoleum. You see a small archway over some stairs leading downwards.

You can see a small box (empty) and Ezmerelda here.

I've always asked myself, why do the undead always have to gather in cemeteries? It's dark, foggy.... It literally smells like death. I don't understand their way of thinking at all. But, you know, maybe that's because I'm not a corpse, yet.

>LOOK
Graveyard
The statue of Death lies in the middle of the Graveyard surrounded by endless rows of tombstones.

To the east, you can barely make out a small grove. To the west, you see what looks to be a small tomb. To the south, you see a large building, probably a mausoleum. You see a small archway over some stairs leading downwards.

You can see a small box (empty) and Ezmerelda here.

Ok, ok, ok. It's not that bad really. I'll find a way into the crypt, get the job done and leave as soon as possible. God knows, I'm a busy man. I don't have time to deal with every single wannabe necromancer who decides to occupy the local cemetery and wreck havoc like the pre-pubescent teen that he is.

>LOOK
Graveyard
The statue of Death lies in the middle of the Graveyard surrounded by endless rows of tombstones.

To the east, you can barely make out a small grove. To the west, you see what looks to be a small tomb. To the south, you see a large building, probably a mausoleum. You see a small archway over some stairs leading downwards.

You can see a small box (empty) and Ezmerelda here.

>LOOK
Graveyard
The statue of Death lies in the middle of the Graveyard surrounded by endless rows of tombstones.

To the east, you can barely make out a small grove. To the west, you see what looks to be a small tomb. To the south, you see a large building, probably a mausoleum. You see a small archway over some stairs leading downwards.

You can see a small box (empty) and Ezmerelda here.

>LOOK
Graveyard
The statue of Death lies in the middle of the Graveyard surrounded by endless rows of tombstones.

To the east, you can barely make out a small grove. To the west, you see what looks to be a small tomb. To the south, you see a large building, probably a mausoleum. You see a small archway over some stairs leading downwards.

You can see a small box (empty) and Ezmerelda here.

Man. Maybe, I'm just too jaded. I'm done this so many, many, many, many, many, many, times that nothing surprises me anymore. I've spent every single day of my life fighting the undead across the world and, I don't know, I feel as if something is missing. Maybe after I cut this losermancer's head off, who probably can't even summon a golem yet, I'll book an appointment with a psychologist.

>LOOK
Graveyard
The statue of Death lies in the middle of the Graveyard surrounded by endless rows of tombstones.

To the east, you can barely make out a small grove. To the west, you see what looks to be a small tomb. To the south, you see a large building, probably a mausoleum. You see a small archway over some stairs leading downwards.

You can see a small box (empty) and Ezmerelda here.

Lilith... God, I loved you Lilith. Why did she have to leave me? I was really happy with her, you know? Granted, I didn't really spend that much time with her... I can't believe she thinks that I'd rather spend my time killing ghouls, solving devious puzzles and burying the dead undead than spend time with her. God... She was an angel, literally and figuratively. Well, I guess if she was a literal angel then she would be a figurative angel by default, right? Anyway, the point is that if you've never been with a girl with wings you're missing out.

>LOOK
Graveyard
The statue of Death lies in the middle of the Graveyard surrounded by endless rows of tombstones.

To the east, you can barely make out a small grove. To the west, you see what looks to be a small tomb. To the south, you see a large building, probably a mausoleum. You see a small archway over some stairs leading downwards.

You can see a small box (empty) and Ezmerelda here.

>LOOK
Graveyard
The statue of Death lies in the middle of the Graveyard surrounded by endless rows of tombstones.

To the east, you can barely make out a small grove. To the west, you see what looks to be a small tomb. To the south, you see a large building, probably a mausoleum. You see a small archway over some stairs leading downwards.

You can see a small box (empty) and Ezmerelda here.

We had so many good memories. A while back, an archdemon was about to suck her into Hell, but I got there just in time and saved her from a life of eternal torment. At the time, she was going out with this angelic douchebag named Metatron. He was gone really fast, after Lilith and I partook in one or two Transformers movie marathons.

>LOOK
Graveyard
The statue of Death lies in the middle of the Graveyard surrounded by endless rows of tombstones.

To the east, you can barely make out a small grove. To the west, you see what looks to be a small tomb. To the south, you see a large building, probably a mausoleum. You see a small archway over some stairs leading downwards.

You can see a small box (empty) and Ezmerelda here.

>LOOK
Graveyard
The statue of Death lies in the middle of the Graveyard surrounded by endless rows of tombstones.

To the east, you can barely make out a small grove. To the west, you see what looks to be a small tomb. To the south, you see a large building, probably a mausoleum. You see a small archway over some stairs leading downwards.

You can see a small box (empty) and Ezmerelda here.

Lilith was my first angel. Maybe I'll never be able to get over her? She hard to handle but she had something special about her. Maybe it was the gothic eye-liner she wore? I don't know, she had something and I'll never be able to get over her. I'm going to die alone, in a crypt without having slept with more than one angel. Come on, this is the fate I've been dished out by the Holy Trinity, after all these years of service?

>LOOK
Graveyard
The statue of Death lies in the middle of the Graveyard surrounded by endless rows of tombstones.

To the east, you can barely make out a small grove. To the west, you see what looks to be a small tomb. To the south, you see a large building, probably a mausoleum. You see a small archway over some stairs leading downwards.

You can see a small box (empty) and Ezmerelda here.

>LOOK
Graveyard
The statue of Death lies in the middle of the Graveyard surrounded by endless rows of tombstones.

To the east, you can barely make out a small grove. To the west, you see what looks to be a small tomb. To the south, you see a large building, probably a mausoleum. You see a small archway over some stairs leading downwards.

You can see a small box (empty) and Ezmerelda here.

All right. I think it's time for me to shut off my internal monologue for the moment while I try to GET INTO THE FUCKING CRYPT SO THAT WE CAN ALL GO HOME.

>LOOK
Graveyard
The statue of Death lies in the middle of the Graveyard surrounded by endless rows of tombstones.

To the east, you can barely make out a small grove. To the west, you see what looks to be a small tomb. To the south, you see a large building, probably a mausoleum. You see a small archway over some stairs leading downwards.

You can see a small box (empty) and Ezmerelda here.